##main Section
main=cinebro.common.controller.MainController
## 
##member Section
meInsert=cinebro.members.controller.MemberInsertController
meEmailCheck=cinebro.members.controller.MemberEmailCheckController
meNicknameCheck=cinebro.members.controller.MemberNicknameCheckController
meInsert=cinebro.members.controller.MemberInsertController
meLogin=cinebro.members.controller.MemberLogInController
meLogout=cinebro.members.controller.MemberLogOutController
meDelete=cinebro.members.controller.MemberDeleteController
##pay Section
bridge=cinebro.pay.controller.BridgeController
pay=cinebro.pay.controller.PayController
##film Section
filmPlay=cinebro.filmplay.controller.FilmPlayController
genrePlay=cinebro.filmplay.controller.GenrePlayController
performance=cinebro.filmplay.controller.performanceController
horror=cinebro.filmplay.controller.horrorController
documentary=cinebro.filmplay.controller.documentaryController
drama=cinebro.filmplay.controller.dramaController
romance=cinebro.filmplay.controller.romanceController
musical=cinebro.filmplay.controller.musicalController
mystery=cinebro.filmplay.controller.mysteryController
crime=cinebro.filmplay.controller.crimeController
historical=cinebro.filmplay.controller.historicalController
western=cinebro.filmplay.controller.westernController
thriller=cinebro.filmplay.controller.thrillerController
animation=cinebro.filmplay.controller.animationController
action=cinebro.filmplay.controller.actionController
adventure=cinebro.filmplay.controller.adventureController
war=cinebro.filmplay.controller.warController
comedy=cinebro.filmplay.controller.comedyController
fantasy=cinebro.filmplay.controller.fantasyController
science=cinebro.filmplay.controller.scienceController
##review Section
reviewList=cinebro.reviews.controller.ReviewListController
reviewEdit=cinebro.reviews.controller.ReviewEditController
reviewDelete=cinebro.reviews.controller.ReviewDeleteController
reviewDetail=cinebro.reviews.controller.ReviewDetailController
likereView=cinebro.reviews.controller.LikeReviewController
##watchedFilm=cinebro.reviews.controller.WatchedFilmController
##wishFilm=cinebro.reviews.controller.WishFilmController
##reviewWrite=cinebro.reviews.controller.ReviewWriteController
##film Section
filmDetail=cinebro.films.controller.FilmDetailController
##filmlist Section
filmList=cinebro.lists.controller.FilmListController
filmListDetail=cinebro.lists.controller.FilmListDetailController
##likefilmList=cinebro.lists.controller.LikeFilmListController
##member Section
memberList=cinebro.following.controller.MemberListController
##memberDetail=cinebro.following.controller.MemberDetailController
##memberFollow=cinebro.following.controller.MemberFollowController
##search Section
search=cinebro.search.controller.SearchController
##profile Section
myproFile=cinebro.profile.controller.MyproFileController
##editNickname=cinebro.profile.controller.EditNicknameController
##myFilms=cinebro.profile.controller.MyFilmsController
##myReviews=cinebro.profile.controller.MyReviewsController
##myWish=cinebro.profile.controller.MyWishController
##myFollowing=cinebro.profile.controller.MyFollowingController
##admin section
##inSertfilm=cinebro.admin.controller.InsertFilmController
##deleteFilm=cinebro.admin.controller.DeleteFilmController